########################################
# ##@@##$      #+++    ###########@@@$$#
# ##$@##$#@@   ######    $$$@@      #$$#
# ##$+##$#@# ### +#$$$# #####@###   ####
# ##$+##$#$#     +#$$$#       #+++++#++#
# ##$+# $#$#   ########$##### #$$$$$$$$#
# ##$+@@$#$##@@     @@@@$@@@@$#$$$######
#@@@  @######@@  ###########$$#$$$######
# @@     # #++ #    ++#####++++++++++++#
########   #++ #                      +#
#########$$#++##+  $$$$$$$$$$$$$$$$$  +#
#+++$$$$$$ #  #++  $$$$$$$$$$$$$$$$$  +#
#+++######## ##++  $  +++++++++++  $  +#
#+++######@  ##++  $  +++++++++++  $  +#
#####@   #@  ##++  $$$$$$$$$$$$$$$$$  +#
#++@@@$# #@#$$########$$$$$$$$$$$$$$  +#
#++ $$$#+++#$$$#+++++++++++++++++++++++#
########################################
