##############################################
#+ @    $#+ @    $#+ @    $#+ @    $#+ @    $#
#+   $#+ @    $#+ @    $#+ @    $#+ @    $#+$#
#+ @    $#+ @    $#+ @    $#+ @    $#+ @    $#
#+ $#+ @    $#+ @    $#+ @    $#+ @    $#+$#+#
#+   $#+ @    $#+ @    $#+ @    $#+ @    $#+$#
#+ @    $#+ @    $#+ @    $#+ @    $#+ @    $#
#+$#+ @    $#+ @    $#+ @    $#+ @    $#+   $#
#+ $#+ @    $#+ @    $#+ @    $#+ @    $#+$#+#
#+ $#+ @    $#+ @    $#+ @    $#+ @    $#+$#+#
#+   $#+ @    $#+ @    $#+ @    $#+ @    $#+$#
#+ @    $#+ @    $#+ @    $#+ @    $#+ @    $#
#+$#+ @    $#+ @    $#+ @    $#+ @    $#+   $#
##+ @    $#+ @    $#+ @    $#+ @    $#+$#+  $#
#+$#+ @    $#+ @    $#+ @    $#+ @    $#+   $#
#+ $#+ @    $#+ @    $#+ @    $#+ @    $#+$#+#
#+$#+ @    $#+ @    $#+ @    $#+ @    $#+$#+$#
#+ @    $#+ @    $#+ @    $#+ @    $#+ @    $#
#+$#+ @    $#+ @    $#+ @    $#+ @    $#+   $#
#+#+ @    $#+ @    $#+ @    $#+ @    $#+$#+ $#
##############################################
