##########################
#$$$$$$$$$$$$$$$$$$$$$$$$#
#$                      $#
#$    ###          @@   $#
#$      @   ++          $#
#$          ++          $#
#$  @       ++     +@+  $#
#$                      $#
#$$$$$$$$$$$$$$$$$$$$$$$$#
##########################
